The	DT
U.S.	NNP
Embassy	NNP
suspended	VBD
operations	NNS
in	IN
Bissau	NNP
on	IN
June	NNP
14	CD
,	,
1998	CD
,	,
in	IN
the	DT
midst	NN
of	IN
violent	JJ
conflict	NN
between	IN
forces	NNS
loyal	JJ
to	IN
then	RB
-	HYPH
President	NNP
Vieira	NNP
and	CC
the	DT
military	JJ
-	HYPH
led	VBN
junta	NN
.	.

Prior	RB
to	IN
and	CC
following	VBG
the	DT
Embassy	NNP
closure	NN
,	,
the	DT
United	NNP
States	NNP
and	CC
Guinea	NNP
-	HYPH
Bissau	NNP
have	VBP
enjoyed	VBN
excellent	JJ
bilateral	JJ
relations	NNS
.	.

