As	IN
might	MD
be	VB
expected	VBN
,	,
critics	NNS
have	VBP
abruptly	RB
divided	VBN
on	IN
this	DT
book	NN
,	,
usually	RB
as	IN
the	DT
result	NN
of	IN
subjective	JJ
political	JJ
opinions	NNS
.	.

Those	DT
who	WP
agree	VBP
with	IN
James	NNP
'	POS
critique	NN
of	IN
the	DT
United	NNP
States	NNP
find	VBP
much	JJ
to	TO
praise	VB
.	.

Those	DT
who	WP
dislike	VBP
his	PRP$
distaste	NN
for	IN
various	JJ
aspects	NNS
of	IN
American	JJ
life	NN
criticize	VBP
James	NNP
as	IN
snobbish	JJ
and	CC
unfair	JJ
.	.

