100	CD
years	NNS
later	RB
,	,
the	DT
visage	NN
of	IN
the	DT
bridge	NN
remains	VBZ
the	DT
subject	NN
of	IN
some	DT
debate	NN
.	.

Already	RB
arguably	RB
less	RBR
attractive	JJ
than	IN
some	DT
of	IN
Dublin	NNP
's	POS
other	JJ
bridges	NNS
,	,
the	DT
façades	NNS
of	IN
the	DT
Loopline	NNP
have	VBP
been	VBN
used	VBN
by	IN
Iarnród	NNP
Éireann	NNP
for	IN
billboard	NN
advertising	NN
.	.

As	IN
of	IN
2006	CD
,	,
the	DT
company	NN
has	VBZ
scaled	VBN
back	RP
the	DT
bridge	NN
's	POS
use	NN
for	IN
this	DT
purpose	NN
to	TO
reduce	VB
impact	NN
on	IN
the	DT
city	NN
skyline	NN
,	,
following	VBG
input	NN
from	IN
An	DT
Bord	NNP
Pleanála	NNP
and	CC
Dublin	NNP
City	NNP
Council	NNP
.	.

