During	IN
World	NNP
War	NNP
II	NNP
,	,
the	DT
Soviet	NNP
Union	NNP
used	VBD
bacteriophages	NNS
to	TO
treat	VB
many	JJ
soldiers	NNS
infected	VBN
with	IN
various	JJ
bacterial	JJ
diseases	NNS
e.g.	XX
dysentery	NN
and	CC
gangrene	NN
.	.

Russian	JJ
researchers	NNS
continued	VBD
to	TO
develop	VB
and	CC
to	TO
refine	VB
their	PRP$
treatments	NNS
and	CC
to	TO
publish	VB
their	PRP$
research	NN
and	CC
results	NNS
.	.

Phage	NN
therapy	NN
is	VBZ
today	NN
a	DT
widespread	JJ
form	NN
of	IN
treatment	NN
in	IN
that	DT
region	NN
.	.

For	IN
80	CD
years	NNS
Georgian	JJ
doctors	NNS
have	VBP
been	VBN
treating	VBG
local	JJ
people	NNS
,	,
including	VBG
babies	NNS
and	CC
newborns	NNS
,	,
with	IN
phages	NNS
.	.

