The	DT
final	JJ
major	JJ
production	NN
model	NN
was	VBD
the	DT
Pfalz	NNP
D.XII	NNP
,	,
a	DT
development	NN
of	IN
the	DT
D.III	NNP
that	WDT
abandoned	VBD
the	DT
sesquiplane	NN
configuration	NN
in	IN
favor	NN
of	IN
two	CD
-	HYPH
bay	NN
wings	NNS
similar	JJ
to	IN
those	DT
of	IN
the	DT
French	JJ
SPAD.	NNP

It	PRP
entered	VBD
the	DT
Second	NNP
Fighter	NNP
Competition	NNP
in	IN
June	NNP
1918	CD
against	IN
the	DT
famous	JJ
Fokker	NNP
E.V	NNP
monoplane	NN
and	CC
other	JJ
designs	NNS
.	.

Although	IN
generally	RB
similar	JJ
to	IN
the	DT
Fokker	NNP
D.VII	NNP
in	IN
looks	NNS
and	CC
performance	NN
,	,
the	DT
D.XII	NNP
was	VBD
widely	RB
considered	VBN
to	TO
be	VB
inferior	JJ
in	IN
handling	VBG
characteristics	NNS
and	CC
difficult	JJ
to	TO
land	VB
.	.

A	DT
few	JJ
aircraft	NNS
were	VBD
eventually	RB
featured	VBN
in	IN
various	JJ
movies	NNS
,	,
notably	RB
'	``
Hell	NNP
's	POS
Angels	NNPS
'	''
and	CC
'	''
The	DT
Dawn	NNP
Patrol	NNP
'	''
.	.

