Dublin	NNP
's	POS
current	JJ
mass	NN
transit	NN
projects	NNS
do	VBP
not	RB
allow	VB
for	IN
easy	JJ
transfers	NNS
.	.

The	DT
existing	VBG
Luas	NNP
light	JJ
rail	NN
lines	NNS
,	,
electrified	VBN
DART	NNP
and	CC
commuter	NN
trains	NNS
do	VBP
not	RB
connect	VB
with	IN
each	DT
other	JJ
adequately	RB
and	CC
to	TO
address	VB
this	DT
an	DT
integrated	VBN
transport	NN
plan	NN
,	,
Transport	NNP
21	CD
,	,
has	VBZ
been	VBN
announced	VBN
.	.

