He	PRP
has	VBZ
also	RB
lost	VBN
some	DT
of	IN
the	DT
charm	NN
and	CC
physical	JJ
attractiveness	NN
he	PRP
previously	RB
possessed	VBD
.	.

Nikki	NNP
Fuller	NNP
-	HYPH
Smith	NNP
-	HYPH
25-year	JJ
old	JJ
university	NN
student	NN
and	CC
film	NN
studies	NNS
major	JJ
who	WP
moonlights	VBD
performing	VBG
minor	JJ
sexual	JJ
favours	NNS
at	IN
a	DT
sauna/massage	NN
parlour	NN
.	.

Lauren	NNP
-	HYPH
Nikki	NNP
's	POS
best	JJS
friend	NN
and	CC
flatmate	NN
,	,
a	DT
feminist	NN
,	,
who	WP
tries	VBZ
to	TO
dissuade	VB
Nikki	NNP
from	IN
being	VBG
in	IN
a	DT
porn	NN
film	NN
.	.

She	PRP
is	VBZ
generally	RB
regarded	VBN
as	IN
a	DT
bore	NN
and	CC
motherly	JJ
figure	NN
.	.

