Gonzalo	NNP
Fernández	NNP
de	NNP
Oviedo	NNP
y	XX
Valdés	NNP
records	VBZ
several	JJ
such	JJ
legends	NNS
in	IN
his	PRP$
'	``
General	NNP
y	NNP
natural	JJ
historia	FW
de	FW
las	FW
Indias	NNP
'	''
of	IN
1526	CD
,	,
which	WDT
includes	VBZ
biographical	JJ
information	NN
on	IN
Columbus	NNP
.	.

The	DT
crew	NN
gathered	VBD
supplies	NNS
and	CC
made	VBD
its	PRP$
way	NN
back	RB
to	IN
Europe	NNP
,	,
but	CC
the	DT
trip	NN
took	VBD
several	JJ
months	NNS
and	CC
the	DT
captain	NN
and	CC
most	JJS
of	IN
the	DT
men	NNS
died	VBD
before	IN
reaching	VBG
land	NN
.	.

The	DT
ship	NN
's	POS
pilot	NN
,	,
a	DT
man	NN
from	IN
somewhere	RB
in	IN
the	DT
Iberian	JJ
peninsula	NN
(	-LRB-
Oviedo	NNP
says	VBZ
different	JJ
versions	NNS
have	VBP
him	PRP
as	IN
Portuguese	JJ
,	,
Basque	JJ
,	,
or	CC
Andalusian	NNP
)	-RRB-
,	,
and	CC
very	RB
few	JJ
others	NNS
finally	RB
made	VBD
it	PRP
to	IN
Portugal	NNP
,	,
but	CC
all	DT
were	VBD
very	RB
ill	JJ
.	.

People	NNS
in	IN
Oviedo	NNP
's	POS
time	NN
knew	VBD
this	DT
story	NN
in	IN
several	JJ
versions	NNS
,	,
but	CC
Oviedo	NNP
regarded	VBD
it	PRP
as	IN
myth	NN
.	.

