The	DT
most	RBS
intense	JJ
open	JJ
warfare	NN
in	IN
the	DT
conflict	NN
in	IN
Western	JJ
Sahara	NNP
occurred	VBD
during	IN
the	DT
Cold	NNP
War	NNP
.	.

But	CC
the	DT
conflict	NN
was	VBD
never	RB
fully	RB
dragged	VBN
into	IN
the	DT
US	NNP
-	HYPH
Soviet	JJ
dynamics	NNS
like	IN
many	JJ
other	JJ
conflicts	NNS
.	.

This	DT
was	VBD
mainly	RB
because	IN
both	DT
sides	NNS
tried	VBD
to	TO
avoid	VB
overt	JJ
involvement	NN
,	,
which	WDT
would	MD
necessitate	VB
a	DT
crash	NN
in	IN
relations	NNS
with	IN
either	CC
Morocco	NNP
or	CC
Algeria	NNP
-	:
the	DT
major	JJ
North	JJ
African	JJ
players	NNS
-	,
and	CC
because	IN
neither	DT
viewed	VBD
it	PRP
as	IN
an	DT
important	JJ
front	NN
.	.

Morocco	NNP
was	VBD
firmly	RB
entrenched	VBN
in	IN
the	DT
US	NNP
camp	NN
,	,
whereas	IN
Algeria	NNP
aligned	VBD
generally	RB
with	IN
the	DT
Soviet	NNP
Union	NNP
during	IN
the	DT
1970s	NNS
,	,
and	CC
took	VBD
a	DT
more	RBR
independent	JJ
"	``
third	RB
-	HYPH
worldist	NN
"	''
position	NN
after	IN
that	DT
.	.

