On	IN
the	DT
web	NN
page	NN
of	IN
the	DT
Falcons	NNPS
read	VBD
the	DT
following	VBG
.	.

It	PRP
is	VBZ
hard	JJ
to	TO
believe	VB
that	IN
we	PRP
are	VBP
about	RB
ready	JJ
to	TO
say	VB
good	JJ
-bye	NN
to	IN
our	PRP$
second	JJ
year	NN
at	IN
Prairie	NNP
Knolls	NNP
Middle	NNP
School	NNP
.	.

Without	IN
the	DT
dedication	NN
and	CC
hard	JJ
work	NN
of	IN
these	DT
individuals	NNS
,	,
evenings	NNS
like	IN
Explore	NNP
PKMS	NNP
would	MD
not	RB
be	VB
possible	JJ
.	.

She	PRP
has	VBZ
coached	VBN
for	IN
many	JJ
years	NNS
and	CC
brings	VBZ
many	JJ
assets	NNS
to	IN
the	DT
program	NN
.	.

We	PRP
wish	VBP
the	DT
best	JJS
of	IN
luck	NN
to	IN
both	CC
Mr.	NNP
Janisch	NNP
and	CC
Ms.	NNP
Brackmann	NNP
.	.

