Since	IN
the	DT
1980s	NNS
,	,
there	EX
have	VBP
been	VBN
several	JJ
instances	NNS
in	IN
the	DT
U.S.	NNP
and	CC
Canada	NNP
where	WRB
official	JJ
public	JJ
mention	NN
and	CC
reference	NN
to	IN
a	DT
Christmas	NNP
tree	NN
was	VBD
renamed	VBN
to	TO
"	``
holiday	NN
tree	NN
"	''
for	IN
various	JJ
reasons	NNS
,	,
mostly	RB
for	IN
enforcement	NN
of	IN
separation	NN
of	IN
church	NN
and	CC
state	NN
or	CC
a	DT
recognition	NN
of	IN
cultural	JJ
and	CC
religious	JJ
diversity	NN
.	.

Marshall	NNP
Astor	NNP
was	VBD
among	IN
those	DT
who	WP
expressed	VBD
outrage	NN
at	IN
these	DT
renamings	NNS
,	,
while	IN
others	NNS
supported	VBD
them	PRP
as	IN
being	VBG
inclusive	JJ
.	.

