Polyelectrolytes	NNS
which	WDT
bear	VBP
both	DT
cationic	JJ
and	CC
anionic	JJ
repeat	NN
groups	NNS
are	VBP
called	VBN
'	``
polyampholytes	NNS
'	''
.	.

The	DT
competition	NN
between	IN
the	DT
acid	NN
-	HYPH
base	NN
equilibria	NN
of	IN
these	DT
groups	NNS
leads	VBZ
to	IN
additional	JJ
complications	NNS
in	IN
their	PRP$
physical	JJ
behavior	NN
.	.

These	DT
polymers	NNS
usually	RB
only	RB
dissolve	VB
when	WRB
there	EX
is	VBZ
sufficient	JJ
added	VBN
salt	NN
,	,
which	WDT
screens	VBZ
the	DT
interactions	NNS
between	IN
oppositely	RB
charged	VBN
segments	NNS
.	.

Many	JJ
proteins	NNS
are	VBP
polyampholytes	NNS
,	,
as	IN
some	DT
amino	NN
acids	NNS
tend	VB
to	TO
be	VB
acidic	JJ
while	IN
others	NNS
are	VBP
basic	JJ
.	.

