The	DT
Indians	NNPS
were	VBD
part	NN
of	IN
the	DT
third	JJ
people	NNS
indigenous	JJ
to	IN
the	DT
area	NN
,	,
the	DT
Canalinos	NNP
.	.

In	IN
prehistoric	JJ
times	NNS
,	,
a	DT
people	NNS
of	IN
Mongolian	JJ
stock	NN
in	IN
all	DT
probability	NN
had	VBD
first	RB
settled	VBN
along	IN
the	DT
Southern	NNP
California	NNP
coast	NN
in	IN
areas	NNS
where	WRB
oak	NN
trees	NNS
were	VBD
plentiful	JJ
,	,
from	IN
which	WDT
characteristic	NN
they	PRP
had	VBD
been	VBN
called	VBN
"	``
The	DT
Oak	NNP
Tree	NNP
(	-LRB-
Grove	NNP
)	-RRB-
People	NNS
"	''
.	.

They	PRP
vanished	VBD
some	DT
hundreds	NNS
of	IN
years	NNS
before	IN
the	DT
beginning	NN
of	IN
the	DT
Christian	JJ
era	NN
,	,
and	CC
after	IN
a	DT
period	NN
yielding	VBG
no	DT
archaeological	JJ
remains	NNS
,	,
a	DT
second	JJ
group	NN
,	,
also	RB
probably	RB
Mongolian	JJ
in	IN
origin	NN
and	CC
semi—nomadic	NN
in	IN
habits	NNS
arrived	VBD
.	.

These	DT
"	``
hunting	VBG
people	NNS
"	''
gradually	RB
merged	VBD
with	IN
a	DT
third	JJ
race	NN
,	,
the	DT
Canalinos	NNP
,	,
on	IN
the	DT
latter	JJ
’s	NN
arrival	NN
.	.

