Lactic	JJ
acid	NN
has	VBZ
been	VBN
suggested	VBN
to	TO
be	VB
a	DT
factor	NN
in	IN
CFS	NNP
because	IN
for	IN
many	JJ
decades	NNS
it	PRP
has	VBZ
been	VBN
commonly	RB
believed	VBN
to	TO
be	VB
responsible	JJ
for	IN
muscle	NN
fatigue	NN
.	.

However	RB
,	,
some	DT
scientists	NNS
have	VBP
found	VBN
that	IN
lactic	JJ
acid	NN
may	MD
actually	RB
help	VB
prevent	VB
muscle	NN
fatigue	NN
rather	RB
than	IN
cause	VB
it	PRP
,	,
by	IN
keeping	VBG
muscles	NNS
properly	RB
responding	VBG
to	IN
nerve	NN
signals	NNS
.	.

