The	DT
Peak	NNP
District	NNP
provides	VBZ
opportunities	NNS
for	IN
many	JJ
types	NNS
of	IN
outdoor	JJ
activity	NN
.	.

An	DT
extensive	JJ
network	NN
of	IN
public	JJ
footpaths	NNS
and	CC
numerous	JJ
long	JJ
-	HYPH
distance	NN
trails	NNS
,	,
over	IN
in	IN
total	JJ
,	,
as	RB
well	RB
as	IN
large	JJ
open	JJ
-	HYPH
access	NN
areas	NNS
,	,
are	VBP
available	JJ
for	IN
hillwalking	VBG
and	CC
hiking	NN
.	.

Bridleways	NNS
are	VBP
commonly	RB
used	VBN
by	IN
mountain	NN
bikers	NNS
,	,
as	RB
well	RB
as	IN
horse	NN
riders	NNS
.	.

Wheelchair	NNP
access	NN
is	VBZ
possible	JJ
at	IN
several	JJ
places	NNS
on	IN
the	DT
former	JJ
railway	NN
trails	NNS
,	,
and	CC
cycle	NN
hire	VBP
centres	NNS
offer	VBP
vehicles	NNS
adapted	VBN
to	IN
wheelchair	NN
users	NNS
.	.

