Body	NN
cleansing	VBG
proponents	NNS
claim	VBP
numerous	JJ
health	NN
benefits	NNS
,	,
including	VBG
the	DT
benefit	NN
to	IN
various	JJ
common	JJ
ailments	NNS
such	JJ
as	IN
acne	NN
,	,
allergies	NNS
,	,
colitis	NN
and	CC
Crohn	NNP
's	POS
disease	NN
,	,
among	IN
other	JJ
conditions	NNS
.	.

While	IN
not	RB
necessarily	RB
a	DT
"	``
cure	NN
"	''
for	IN
these	DT
conditions	NNS
,	,
it	PRP
is	VBZ
believed	VBN
that	IN
body	NN
cleansing	VBG
benefits	NNS
various	JJ
ailments	NNS
through	IN
allowing	VBG
the	DT
body	NN
to	TO
perform	VB
optimally	RB
and	CC
to	TO
utilize	VB
its	PRP$
innate	JJ
ability	NN
to	TO
regain	VB
balance	NN
.	.

