Often	RB
,	,
parts	NNS
-	HYPH
per	IN
notation	NN
is	VBZ
the	DT
simplest	JJS
and	CC
best	JJS
measure	NN
.	.

But	CC
other	JJ
times	NNS
,	,
it	PRP
is	VBZ
less	RBR
suitable	JJ
or	CC
even	RB
impossible	JJ
.	.

This	DT
sometimes	RB
results	VBZ
in	IN
agencies	NNS
such	JJ
as	IN
the	DT
World	NNP
Health	NNP
Organization	NNP
or	CC
US	NNP
EPA	NNP
presenting	VBG
entire	JJ
tables	NNS
of	IN
air	NN
concentrations	NNS
that	WDT
use	VBP
the	DT
weight/volume	JJ
method	NN
,	,
when	WRB
parts	NNS
-	HYPH
per	IN
notation	NN
might	MD
have	VB
more	RBR
readily	RB
worked	VBN
for	IN
many	JJ
(	-LRB-
but	CC
not	RB
all	DT
)	-RRB-
substances	NNS
present	JJ
.	.

While	IN
many	JJ
contaminants	NNS
can	MD
be	VB
easily	RB
described	VBN
using	VBG
parts	NNS
-	HYPH
per	IN
notation	NN
,	,
a	DT
few	JJ
of	IN
them	PRP
present	VBD
a	DT
much	RB
more	RBR
complex	JJ
picture	NN
.	.

