Casey	NNP
Bartholomew	NNP
was	VBD
born	VBN
in	IN
1969	CD
in	IN
Orange	NNP
County	NNP
,	,
California	NNP
,	,
and	CC
attended	VBD
Fulton	NNP
College	NNP
.	.

He	PRP
was	VBD
the	DT
board	NN
operator	NN
for	IN
Laura	NNP
Schlessinger	NNP
's	POS
show	NN
on	IN
KFI	NNP
in	IN
Los	NNP
Angeles	NNP
,	,
1991	CD
-	SYM
95	CD
,	,
then	RB
for	IN
two	CD
years	NNS
hosted	VBD
a	DT
weekend	NN
KFI	NNP
talk	NN
show	NN
with	IN
Scott	NNP
Hasick	NNP
.	.

The	DT
Scott	NNP
and	CC
Casey	NNP
show	VBP
was	VBD
also	RB
heard	VBN
in	IN
the	DT
2	CD
-	SYM
7	CD
pm	NN
time	NN
slot	NN
on	IN
New	NNP
Jersey	NNP
101.5	CD
from	IN
August	NNP
1999	CD
to	IN
July	NNP
2002	CD
.	.

