Port	VB
-	HYPH
wine	NN
stains	NNS
occur	VBP
most	RBS
often	RB
on	IN
the	DT
face	NN
but	CC
can	MD
appear	VB
anywhere	RB
on	IN
the	DT
body	NN
.	.

Early	JJ
stains	NNS
are	VBP
usually	RB
flat	JJ
and	CC
pink	JJ
in	IN
appearance	NN
.	.

As	IN
the	DT
child	NN
matures	NNS
,	,
the	DT
color	NN
may	MD
deepen	VB
to	IN
a	DT
dark	JJ
red	JJ
or	CC
purplish	JJ
colour	NN
.	.

In	IN
adulthood	NN
,	,
thickening	NN
of	IN
the	DT
lesion	NN
or	CC
the	DT
development	NN
of	IN
small	JJ
lumps	NNS
may	MD
occur	VB
.	.

