Volvo	NNP
IT	PRP
has	VBZ
around	RB
5000	CD
employees	NNS
and	CC
offices	NNS
in	IN
GÃ¶teborg	NNP
,	,
Ghent	NNP
,	,
Lyon	NNP
,	,
Greensboro	NNP
and	CC
Kuala	NNP
Lumpur	NNP
.	.

