Some	DT
of	IN
its	PRP$
methods	NNS
,	,
however	RB
,	,
have	VBP
come	VBN
under	IN
question	NN
,	,
viewed	VBN
by	IN
the	DT
cannabis	JJ
community	NN
as	IN
overt	JJ
propaganda	NN
.	.

One	CD
advertisement	NN
,	,
for	IN
example	NN
,	,
features	VBZ
a	DT
dog	NN
judging	VBG
and	CC
alienating	VBG
an	DT
individual	NN
for	IN
smoking	VBG
marijuana	NN
,	,
reinforcing	VBG
social	JJ
prejudice	NN
and	CC
detachment	NN
from	IN
teen	NN
marijuana	NN
users	NNS
,	,
instead	RB
of	IN
advocating	VBG
support	NN
systems	NNS
.	.

In	IN
addition	NN
,	,
the	DT
legality	NN
of	IN
using	VBG
government	NN
funding	NN
to	TO
support	VB
social	JJ
perceptions	NNS
about	IN
drugs	NNS
instead	RB
of	IN
informing	VBG
people	NNS
of	IN
their	PRP$
negative	JJ
effects	NNS
is	VBZ
highly	RB
controversial	JJ
,	,
claimed	VBN
by	IN
those	DT
opposing	VBG
the	DT
advertising	NN
campaign	NN
to	TO
be	VB
the	DT
precise	JJ
definition	NN
of	IN
propaganda	NN
.	.

The	DT
majority	NN
of	IN
cannabis	NN
users	NNS
feel	VB
that	IN
these	DT
adverts	NNS
encourage	VBP
discrimination	NN
against	IN
them	PRP
,	,
insult	VB
them	PRP
,	,
encourage	VB
their	PRP$
alienation	NN
from	IN
society	NN
and	CC
make	VB
them	PRP
look	VB
like	IN
hard	JJ
drug	NN
users	NNS
.	.

