Symptoms	NNS
of	IN
leaf	NN
blight	NN
infections	NNS
begin	VBP
as	IN
one	CD
to	IN
several	JJ
circular	JJ
reddish	NN
-	HYPH
purple	JJ
spots	NNS
on	IN
a	DT
leaflet	NN
.	.

Lesions	NNS
follow	VBP
major	JJ
veins	NNS
progressing	VBG
inward	RB
.	.

The	DT
whole	JJ
leaflet	NN
may	MD
turn	VB
brown	JJ
.	.

In	IN
severe	JJ
cases	NNS
,	,
stolons	NNS
,	,
fruit	NN
trusses	NNS
and	CC
petioles	NNS
may	MD
become	VB
infected	JJ
which	WDT
may	MD
girdle	VB
and	CC
kill	VB
the	DT
stem	NN
.	.

