In	IN
the	DT
United	NNP
Kingdom	NNP
,	,
ambulance	NN
services	NNS
became	VBD
largely	RB
municipal	JJ
services	NNS
,	,
with	IN
some	DT
exceptions	NNS
,	,
shortly	RB
after	IN
the	DT
end	NN
of	IN
World	NNP
War	NNP
Two	CD
.	.

All	DT
public	JJ
ambulance	NN
services	NNS
are	VBP
currently	RB
operated	VBN
by	IN
regional	JJ
entities	NNS
,	,
most	RBS
often	RB
'	``
trusts	NNS
'	''
,	,
under	IN
the	DT
authority	NN
of	IN
the	DT
National	NNP
Health	NNP
Service	NNP
.	.

Most	JJS
services	NNS
train	VBP
these	DT
individuals	NNS
internally	RB
,	,
using	VBG
a	DT
common	JJ
curriculum	NN
.	.

Initially	RB
,	,
many	JJ
of	IN
these	DT
individuals	NNS
were	VBD
trained	VBN
internally	RB
by	IN
the	DT
services	NNS
that	WDT
employed	VBD
them	PRP
,	,
with	IN
the	DT
step	NN
to	IN
Paramedic	NNP
being	VBG
a	DT
logical	JJ
career	NN
path	NN
progression	NN
for	IN
an	DT
experienced	JJ
Ambulance	NNP
Technician	NNP
.	.

