The	DT
New	NNP
Testament	NNP
goes	VBZ
on	RP
to	TO
say	VB
that	IN
Paul	NNP
was	VBD
himself	PRP
imprisoned	VBN
on	IN
several	JJ
occasions	NNS
by	IN
the	DT
Roman	JJ
authorities	NNS
,	,
stoned	VBN
by	IN
Pharisees	NNPS
and	CC
left	VBD
for	IN
dead	JJ
on	IN
one	CD
occasion	NN
,	,
and	CC
was	VBD
eventually	RB
taken	VBN
as	IN
a	DT
prisoner	NN
to	IN
Rome	NNP
.	.

Peter	NNP
and	CC
others	NNS
were	VBD
also	RB
imprisoned	VBN
,	,
beaten	VBN
and	CC
generally	RB
harassed	VBN
.	.

Because	IN
of	IN
severe	JJ
persecution	NN
in	IN
Jerusalem	NNP
,	,
most	JJS
of	IN
the	DT
Nazarenes	NNPS
were	VBD
forced	VBN
to	TO
leave	VB
.	.

James	NNP
was	VBD
said	VBN
to	TO
have	VB
been	VBN
put	VBN
to	IN
death	NN
around	IN
that	DT
time	NN
.	.

