It	PRP
is	VBZ
a	DT
huge	JJ
complex	NN
of	IN
buildings	NNS
spread	VBN
across	IN
acres	NNS
of	IN
land	NN
sprinkled	VBN
with	IN
many	JJ
lawns	NNS
.	.

The	DT
complex	JJ
houses	NNS
many	JJ
pavilions	NNS
like	IN
the	DT
Nehru	NNP
Pavilion	NNP
,	,
the	DT
Defense	NNP
Pavilion	NNP
,	,
the	DT
Indira	NNP
Pavilion	NNP
,	,
and	CC
the	DT
Son	NNP
of	IN
India	NNP
Pavilion	NNP
.	.

It	PRP
has	VBZ
various	JJ
building	NN
which	WDT
are	VBP
build	VBN
in	IN
various	JJ
shapes	NNS
and	CC
sizes	NNS
.	.

Pragati	NNP
maidan	NN
houses	VBZ
a	DT
movie	NN
theatre	NN
called	VBN
Shakuntalam	NNP
,	,
it	PRP
's	VBZ
quite	RB
popular	JJ
among	IN
college	NN
kids	NNS
for	IN
its	PRP$
comparatively	RB
cheap	JJ
tickets	NNS
.	.

