The	DT
ubiquitous	JJ
presence	NN
of	IN
such	JJ
estrogenic	JJ
substances	NNS
is	VBZ
a	DT
significant	JJ
health	NN
concern	NN
,	,
both	CC
individually	RB
and	CC
for	IN
a	DT
population	NN
.	.

Life	NN
relies	VBZ
on	IN
the	DT
transmission	NN
of	IN
biochemical	JJ
information	NN
to	IN
the	DT
next	JJ
generation	NN
,	,
and	CC
the	DT
presence	NN
of	IN
xenoestrogens	NNS
may	MD
interfere	VB
with	IN
this	DT
transgenerational	JJ
information	NN
process	NN
through	IN
"	``
chemical	JJ
confusion	NN
"	''
(	-LRB-
Vidaeff	NNP
and	CC
Sever	NNP
)	-RRB-
.	.

PMID	NNP
1580878	CD
,	,
who	WP
state	NN
:	:
"	``
The	DT
results	NNS
do	VBP
not	RB
support	VB
with	IN
certainty	NN
the	DT
view	NN
that	IN
environmental	JJ
estrogens	NNS
contribute	VBP
to	IN
an	DT
increase	NN
in	IN
male	JJ
reproductive	JJ
disorders	NNS
"	''
.	.

Agencies	NNS
such	JJ
as	IN
the	DT
United	NNP
States	NNP
Environmental	NNP
Protection	NNP
Agency	NNP
and	CC
the	DT
World	NNP
Health	NNP
Organization	NNP
International	NNP
Program	NNP
on	IN
Chemical	NNP
Safety	NNP
are	VBP
charged	VBN
to	TO
address	VB
these	DT
issues	NNS
.	.

