These	DT
two	CD
open	JJ
clusters	NNS
(	-LRB-
NGC	NNP
869	CD
and	CC
NGC	NNP
884	CD
respectively	RB
)	-RRB-
belong	VBP
to	IN
the	DT
most	RBS
beautiful	JJ
objects	NNS
of	IN
the	DT
night	NN
sky	NN
for	IN
binoculars	NNS
and	CC
small	JJ
telescopes	NNS
.	.

Both	DT
lie	VBP
at	IN
distances	NNS
of	IN
more	JJR
than	IN
7,000	CD
ly	NN
and	CC
are	VBP
separated	VBN
by	IN
several	JJ
hundred	CD
light	NN
-	HYPH
years	NNS
.	.

M34	NN
:	:
This	DT
open	JJ
cluster	NN
with	IN
an	DT
apparent	JJ
brightness	NN
of	IN
5.5m	NN
lies	VBZ
at	IN
a	DT
distance	NN
of	IN
approximately	RB
1,400	CD
ly	NN
and	CC
consists	VBZ
of	IN
about	RB
100	CD
stars	NNS
that	WDT
are	VBP
scattered	VBN
over	IN
an	DT
area	NN
larger	JJR
than	IN
that	DT
of	IN
the	DT
full	JJ
moon	NN
.	.

M	NNP
34	CD
can	MD
be	VB
resolved	VBN
even	RB
with	IN
good	JJ
binoculars	NNS
but	CC
is	VBZ
best	RBS
viewed	VBN
using	VBG
a	DT
telescope	NN
at	IN
low	JJ
magnifications	NNS
.	.

