'	``
Better	NNP
World	NNP
Books	NNPS
'	POS
is	VBZ
a	DT
controversial	JJ
American	NNP
for	IN
-	HYPH
profit	NN
social	JJ
enterprise	NN
that	WDT
collects	VBZ
used	JJ
books	NNS
and	CC
sells	VBZ
them	PRP
to	TO
raise	VB
funding	NN
for	IN
over	IN
80	CD
non	JJ
-	HYPH
profit	NN
literacy	NN
programs	NNS
.	.

