In	IN	_
Sri	NNP	_
Lanka	NNP	_
,	,	_
polyandry	JJ	_
was	VBD	_
practiced	VBN	_
(	-LRB-	_
though	IN	_
not	RB	_
widespread	JJ	_
)	-RRB-	_
till	IN	_
recent	JJ	_
times	NNS	_
.	.	_

When	WRB	_
the	DT	_
Buddhist	NNP	_
texts	NNS	_
were	VBD	_
translated	VBN	_
into	IN	_
Chinese	NNP	_
,	,	_
the	DT	_
concubines	NNS	_
of	IN	_
others	NNS	_
were	VBD	_
added	VBN	_
to	IN	_
the	DT	_
list	NN	_
of	IN	_
inappropriate	JJ	_
partners	NNS	_
.	.	_

In	IN	_
Tibet	NNP	_
as	RB	_
well	RB	_
,	,	_
both	CC	_
polygyny	NN	_
and	CC	_
polyandry	JJ	_
were	VBD	_
commonly	RB	_
practiced	VBN	_
.	.	_

Having	VBG	_
several	JJ	_
wives	NNS	_
or	CC	_
several	JJ	_
husbands	NNS	_
was	VBD	_
never	RB	_
regarded	VBN	_
as	IN	_
having	VBG	_
sex	NN	_
with	IN	_
inappropriate	JJ	_
partners	NNS	_
.	.	_

