There	EX	_
is	VBZ	_
some	DT	CUE-1
evidence	NN	CUE-1
suggesting	VBG	CUE-2
that	IN	_
administering	VBG	_
glucocorticoids	NNS	_
immediately	RB	_
after	IN	_
a	DT	_
traumatic	JJ	_
experience	NN	_
may	MD	CUE-3
help	NN	_
prevent	VB	_
PTSD.	NNP	_

Several	JJ	CUE-1
studies	NNS	CUE-1
have	VBP	_
shown	VBN	_
that	IN	_
patients	NNS	_
who	WP	_
receive	VBP	_
high	JJ	_
doses	NNS	_
of	IN	_
hydrocortisone	NN	_
for	IN	_
treatment	NN	_
of	IN	_
septic	JJ	_
shock	NN	_
or	CC	_
following	VBG	_
surgery	NN	_
have	VBP	_
a	DT	_
lower	JJR	_
incidence	NN	_
and	CC	_
fewer	JJR	_
symptoms	NNS	_
of	IN	_
PTSD.	NNP	_

In	IN	_
this	DT	_
study	NN	_
,	,	_
corticosterone	NN	_
impaired	VBD	_
memory	NN	_
performance	NN	_
,	,	_
suggesting	VBG	CUE-1
that	IN	_
it	PRP	_
may	MD	CUE-2
reduce	VB	_
risk	NN	_
for	IN	_
PTSD	NNP	_
by	IN	_
interfering	VBG	_
with	IN	_
consolidation	NN	_
of	IN	_
traumatic	JJ	_
memories	NNS	_
.	.	_

The	DT	_
neurodegenerative	JJ	_
effects	NNS	_
of	IN	_
the	DT	_
glucocorticoids	NNS	_
,	,	_
however	RB	_
,	,	_
may	MD	CUE-1
prove	VB	_
this	DT	_
treatment	NN	_
counterproductive	JJ	_
.	.	_

