However	RB	_
,	,	_
recently	RB	_
it	PRP	CUE-1
has	VBZ	CUE-1
been	VBN	CUE-1
said	VBN	CUE-1
that	IN	_
"	``	_
Shadows	NNPS	_
and	CC	_
Regrets	NNPS	_
"	''	_
is	VBZ	_
about	IN	_
Scott	NNP	_
Shad	NNP	_
,	,	_
former	JJ	_
drummer	NN	_
of	IN	_
Inspection	NNP	_
12	CD	_
and	CC	_
best	JJS	_
friend	NN	_
of	IN	_
Ryan	NNP	_
Key	NNP	_
,	,	_
who	WP	_
died	VBD	_
in	IN	_
a	DT	_
car	NN	_
crash	NN	_
.	.	_

And	CC	_
we	PRP	_
were	VBD	_
best	JJS	_
of	IN	_
friends	NNS	_
.	.	_

And	CC	_
we	PRP	_
hoped	VBD	_
for	IN	_
the	DT	_
best	JJS	_
.	.	_

While	IN	_
this	DT	_
could	MD	_
understandably	RB	_
be	VB	_
about	IN	_
Ben	NNP	_
Harper	NNP	_
,	,	_
he	PRP	_
and	CC	_
Key	NNP	_
only	RB	_
met	VBD	_
in	IN	_
high	JJ	_
school	NN	_
,	,	_
whereas	IN	_
Key	NNP	_
and	CC	_
Shad	NNP	_
knew	VBD	_
each	DT	_
other	JJ	_
their	PRP$	_
entire	JJ	_
lives	NNS	_
.	.	_

