In	IN	_
his	PRP$	_
book	NN	_
'	``	_
The	DT	_
Natural	JJ	_
History	NN	_
of	IN	_
the	DT	_
Point	NNP	_
Reyes	NNP	_
Peninsula	NNP	_
'	''	_
,	,	_
Jules	NNP	_
Evens	NNP	_
identifies	VBZ	_
several	JJ	_
plant	NN	_
communities	NNS	_
.	.	_

One	CD	_
of	IN	_
the	DT	_
most	RBS	_
prominent	JJ	_
is	VBZ	_
the	DT	_
Coastal	NNP	_
Douglas	NNP	_
-	HYPH	_
fir	NN	_
(	-LRB-	_
'	``	_
Pseudotsuga	NNP	_
menziesii	NN	_
'	''	_
)	-RRB-	_
forest	NN	_
,	,	_
which	WDT	_
includes	VBZ	_
Coast	NNP	_
live	JJ	_
oak	NN	_
,	,	_
Tanoak	NNP	_
,	,	_
and	CC	_
California	NNP	_
bay	NN	_
and	CC	_
reaches	VBZ	_
across	IN	_
the	DT	_
southern	JJ	_
half	NN	_
of	IN	_
Inverness	NNP	_
Ridge	NNP	_
toward	IN	_
Bolinas	NNP	_
Lagoon	NNP	_
.	.	_

But	CC	_
despite	IN	_
these	DT	_
large	JJ	_
,	,	_
old	JJ	_
trees	NNS	_
,	,	_
the	DT	_
forest	NN	_
may	MD	CUE-1
nevertheless	RB	_
be	VB	_
a	DT	_
result	NN	_
of	IN	_
European	JJ	_
settlement	NN	_
.	.	_

The	DT	_
Coast	NNP	_
Miwok	NNP	_
people	NNS	_
who	WP	_
once	RB	_
lived	VBD	_
in	IN	_
the	DT	_
area	NN	_
set	VBD	_
frequent	JJ	_
fires	NNS	_
to	TO	_
clear	VB	_
brush	NN	_
and	CC	_
increase	VB	_
game	NN	_
animal	NN	_
populations	NNS	_
,	,	_
and	CC	_
early	JJ	_
explorers	NNS	_
'	POS	_
accounts	NNS	_
describe	VBP	_
the	DT	_
hills	NNS	_
as	IN	_
bare	JJ	_
and	CC	_
grassy	JJ	_
.	.	_

