There	EX	_
are	VBP	_
over	IN	_
700	CD	_
recognized	VBN	_
species	NNS	_
and	CC	_
subspecies	NNS	_
of	IN	_
'	``	_
Perdita	NNP	_
'	''	_
,	,	_
plus	CC	_
some	DT	_
200	CD	_
more	JJR	_
as	IN	_
yet	RB	_
unnamed	VBN	_
.	.	_

'	``	_
Perdita	NNP	_
'	''	_
are	VBP	_
usually	RB	_
quite	RB	_
small	JJ	_
(	-LRB-	_
2.0	CD	_
mm	NN	_
to	IN	_
10.0	CD	_
mm	NN	_
)	-RRB-	_
and	CC	_
often	RB	_
brightly	RB	_
colored	VBN	_
with	IN	_
metallic	JJ	_
reflections	NNS	_
and/or	CC	_
yellow	JJ	_
or	CC	_
white	JJ	_
markings	NNS	_
.	.	_

The	DT	_
genus	NN	_
was	VBD	_
extensively	RB	_
treated	VBN	_
by	IN	_
P.H.	NNP	_
Timberlake	NNP	_
who	WP	_
,	,	_
in	IN	_
addition	NN	_
to	IN	_
T.D.A.	NNP	_
Cockerell	NNP	_
,	,	_
described	VBD	_
most	JJS	_
of	IN	_
the	DT	_
known	VBN	_
species	NNS	_
.	.	_

Most	JJS	CUE-1
species	NNS	CUE-1
are	VBP	_
extreme	JJ	_
specialists	NNS	_
(	-LRB-	_
oligoleges	NNS	_
)	-RRB-	_
with	IN	_
respect	NN	_
to	IN	_
pollen	NN	_
and	CC	_
will	MD	_
only	RB	_
collect	VB	_
pollen	NN	_
from	IN	_
a	DT	_
few	JJ	_
closely	RB	_
related	JJ	_
species	NNS	_
or	CC	_
genera	NN	_
of	IN	_
plants	NNS	_
.	.	_

