The	DT	_
word	NN	_
"	``	_
gremlin	NN	_
"	''	_
originated	VBD	_
in	IN	_
oral	JJ	_
use	NN	_
amongst	IN	_
R.A.F.	NNP	_
aviators	NNS	_
'	POS	_
slang	NN	_
in	IN	_
Malta	NNP	_
,	,	_
the	DT	_
Middle	NNP	_
East	NNP	_
and	CC	_
India	NNP	_
and	CC	_
is	VBZ	CUE-1
said	VBN	CUE-1
to	IN	_
date	NN	_
to	IN	_
1923	CD	_
;	:	_
with	IN	_
the	DT	_
earliest	JJS	_
recorded	VBN	_
printed	VBN	_
use	VBP	_
being	VBG	_
a	DT	_
poem	NN	_
published	VBN	_
in	IN	_
the	DT	_
journal	NN	_
'	``	_
Aeroplane	NNP	_
'	''	_
April	NNP	_
10	CD	_
,	,	_
1929	CD	_
.	.	_

The	DT	_
concept	NN	_
of	IN	_
gremlins	NNS	_
as	IN	_
responsible	JJ	_
for	IN	_
sabotaging	VBG	_
aircraft	NN	_
was	VBD	_
popularized	VBN	_
during	IN	_
World	NNP	_
War	NNP	_
II	NNP	_
among	IN	_
airmen	NNS	_
of	IN	_
Britain	NNP	_
's	POS	_
Royal	NNP	_
Air	NNP	_
Force	NNP	_
,	,	_
in	IN	_
particular	JJ	_
the	DT	_
men	NNS	_
of	IN	_
the	DT	_
high	JJ	_
altitude	NN	_
Photographic	NNP	_
Reconnaissance	NNP	_
Units	NNP	_
(	-LRB-	_
PRU	NNP	_
)	-RRB-	_
of	IN	_
RAF	NNP	_
Benson	NNP	_
,	,	_
RAF	NNP	_
Wick	NNP	_
and	CC	_
RAF	NNP	_
St	NNP	_
Eval	NNP	_
.	.	_

The	DT	_
story	NN	_
attempted	VBD	_
to	TO	_
explain	VB	_
the	DT	_
accidents	NNS	_
which	WDT	_
often	RB	_
occurred	VBD	_
during	IN	_
their	PRP$	_
flights	NNS	_
.	.	_

Gremlins	NNS	_
were	VBD	CUE-1
also	RB	CUE-1
thought	VBN	CUE-1
to	TO	_
have	VB	_
enemy	NN	_
sympathies	NNS	_
,	,	_
but	CC	_
investigation	NN	_
revealed	VBD	_
that	IN	_
the	DT	_
enemy	NN	_
also	RB	_
had	VBD	_
similar	JJ	_
problems	NNS	_
,	,	_
so	IN	_
the	DT	_
gremlins	NNS	_
were	VBD	_
not	RB	_
taking	VBG	_
sides	NNS	_
in	IN	_
the	DT	_
conflict	NN	_
.	.	_
}	-RRB-	_
}	-RRB-	_

In	IN	_
reality	NN	_
,	,	_
the	DT	_
gremlins	NNS	_
were	VBD	_
a	DT	_
form	NN	_
of	IN	_
"	``	_
buck	NN	_
passing	NN	_
"	''	_
or	CC	_
deflecting	VBG	_
blame	NN	_
.	.	_

