The	DT	_
puzzle	NN	_
piece	NN	_
ribbon	NN	_
is	VBZ	_
used	VBN	_
by	IN	_
some	DT	CUE-1
autism	NN	CUE-1
societies	NNS	CUE-1
.	.	_

Some	DT	CUE-1
autistic	JJ	CUE-1
adults	NNS	CUE-1
find	VB	_
this	DT	_
ribbon	NN	_
offensive	JJ	_
and	CC	_
insulting	VBG	_
.	.	_

Some	DT	CUE-1
people	NNS	CUE-1
have	VB	_
the	DT	_
goal	NN	_
of	IN	_
eliminating	VBG	_
autism	NN	_
completely	RB	_
;	:	_
since	IN	_
those	DT	_
in	IN	_
the	DT	_
autism	NN	_
rights	NNS	_
movement	NN	_
see	VBP	_
autism	NN	_
as	IN	_
a	DT	_
natural	JJ	_
human	NN	_
variation	NN	_
and	CC	_
not	RB	_
a	DT	_
disorder	NN	_
,	,	_
they	PRP	_
are	VBP	_
opposed	VBN	_
to	IN	_
attempts	NNS	_
to	TO	_
eliminate	VB	_
autism	NN	_
.	.	_

