At	IN	_
dawn	NN	_
,	,	_
the	DT	_
Romans	NNPS	_
started	VBD	_
to	TO	_
cross	VB	_
the	DT	_
river	NN	_
Siris	NNP	_
.	.	_

The	DT	_
Roman	JJ	_
cavalry	NN	_
attacked	VBD	_
on	IN	_
the	DT	_
flanks	NNS	_
the	DT	_
scouts	NNS	_
and	CC	_
light	JJ	_
infantry	NN	_
,	,	_
who	WP	_
were	VBD	_
forced	VBN	_
to	TO	_
flee	VB	_
.	.	_

