The	DT	_
frequency	NN	_
of	IN	_
these	DT	_
problems	NNS	_
vary	VBP	_
for	IN	_
each	DT	_
individual	JJ	_
user	NN	_
;	:	_
some	DT	CUE-1
users	NNS	CUE-1
claim	NN	_
that	IN	_
they	PRP	CUE-2
have	VBP	_
never	RB	_
or	CC	_
rarely	RB	_
experienced	VBD	_
these	DT	_
problems	NNS	_
,	,	_
while	IN	_
others	NNS	CUE-3
claim	NN	_
to	TO	_
experience	VB	_
them	PRP	_
very	RB	_
often	RB	_
.	.	_

Also	RB	_
I	PRP	CUE-1
advise	VBP	CUE-1
anyone	NN	_
to	TO	_
stay	VB	_
away	RB	_
from	IN	_
Satman	NNP	_
aka	RB	_
FireKing83	NNP	_
on	IN	_
Olympus	NNP	_
.	.	_

After	IN	_
meeting	VBG	_
him	PRP	_
you	PRP	CUE-1
will	MD	_
probably	RB	CUE-2
be	VB	_
left	VBN	_
with	IN	_
a	DT	_
gaping	VBG	_
asshole	NN	_
,	,	_
due	IN	_
to	IN	_
his	PRP$	_
fixation	NN	_
with	IN	_
male	JJ	_
anus	NN	_
's	POS	_
.	.	_

