Photobiotin	NNP	_
is	VBZ	_
used	VBN	_
in	IN	_
many	JJ	CUE-1
biology	NN	CUE-1
laboratories	NNS	CUE-1
for	IN	_
patterning	VBG	_
proteins	NNS	_
,	,	_
ligands	NNS	_
,	,	_
and	CC	_
other	JJ	_
species	NNS	_
onto	IN	_
solid	JJ	_
substrates	NNS	_
.	.	_

UV	NN	_
lasers	NNS	_
stimulate	VBP	_
photobiotin	NN	_
to	TO	_
attach	VB	_
various	JJ	CUE-1
surfaces	NNS	CUE-1
,	,	_
where	WRB	_
scientists	NNS	CUE-2
can	MD	_
visualize	VB	_
the	DT	_
distribution	NN	_
of	IN	_
the	DT	_
species	NNS	_
that	WDT	_
they	PRP	_
are	VBP	_
looking	VBG	_
for	IN	_
.	.	_

For	IN	_
example	NN	_
,	,	_
at	IN	_
Texas	NNP	_
A&M	NNP	_
University	NNP	_
in	IN	_
2003	CD	_
,	,	_
researchers	NNS	_
used	VBD	_
photobiotin	NN	_
to	TO	_
develop	VB	_
a	DT	_
new	JJ	_
way	NN	_
to	TO	_
bind	VB	_
inorganic	JJ	_
and	CC	_
organic	JJ	_
species	NNS	_
onto	IN	_
solid	JJ	_
substrates	NNS	_
.	.	_

Using	VBG	_
this	DT	_
technique	NN	_
,	,	_
they	PRP	_
were	VBD	_
able	JJ	_
to	TO	_
bind	VB	_
several	JJ	CUE-1
species	NNS	CUE-1
to	IN	_
the	DT	_
surface	NN	_
simultaneously	RB	_
using	VBG	_
different	JJ	_
frequencies	NNS	_
of	IN	_
UV	NNP	_
laser	NN	_
light	NN	_
.	.	_

