It	PRP	_
is	VBZ	_
widely	RB	_
used	VBN	_
in	IN	_
Scouting	NNP	_
and	CC	_
Girl	NNP	_
Guiding	NNP	_
.	.	_

Many	JJ	_
Scout	NN	_
and	CC	_
Guide	NNP	_
groups	NNS	_
train	VBP	_
their	PRP$	_
members	NNS	_
in	IN	_
pioneering	JJ	_
skills	NNS	_
and	CC	_
construct	VB	_
projects	NNS	_
,	,	_
both	CC	_
small	JJ	_
and	CC	_
large	JJ	_
.	.	_

In	IN	_
camp	NN	_
,	,	_
Scouts	NNPS	_
may	MD	_
construct	VB	_
functional	JJ	_
items	NNS	_
like	IN	_
tables	NNS	_
,	,	_
camp	NN	_
dressers	NNS	_
and	CC	_
gadgets	NNS	_
,	,	_
as	RB	_
well	RB	_
as	IN	_
decorative	JJ	_
camp	NN	_
gateways	NNS	_
.	.	_

Pioneering	NN	_
is	VBZ	_
a	DT	_
common	JJ	_
merit	NN	_
badge	NN	_
in	IN	_
many	JJ	CUE-1
countries	NNS	CUE-1
,	,	_
and	CC	_
was	VBD	_
required	VBN	_
for	IN	_
Eagle	NNP	_
in	IN	_
the	DT	_
1920s	NNS	_
and	CC	_
1930s	NNS	_

