Many	JJ	CUE-1
consider	VB	_
the	DT	_
steam	NN	_
locomotive	NN	_
to	TO	_
be	VB	_
one	CD	CUE-2
of	IN	CUE-2
the	DT	CUE-2
most	RBS	CUE-2
fascinating	JJ	CUE-2
mechanical	JJ	_
devices	NNS	_
ever	RB	_
created	VBN	_
and	CC	_
passing	VBG	_
steam	NN	_
locomotives	NNS	_
often	RB	_
grab	VBP	_
the	DT	_
attention	NN	_
of	IN	_
bystanders	NNS	_
.	.	_

