Podophyllin	NNP	_
has	VBZ	_
been	VBN	_
used	VBN	_
to	TO	_
remove	VB	_
genital	NN	_
warts	NNS	_
since	IN	_
its	PRP$	_
efficacy	NN	_
was	VBD	_
first	RB	_
demonstrated	VBN	_
in	IN	_
1942	CD	_
,	,	_
although	IN	_
the	DT	_
reliability	NN	_
of	IN	_
this	DT	_
early	JJ	_
report	NN	_
has	VBZ	_
been	VBN	_
questioned	VBN	_
.	.	_

Petroleum	NN	_
jelly	RB	_
,	,	_
such	JJ	_
as	IN	_
Vaseline	NNP	_
,	,	_
may	MD	_
be	VB	_
used	VBN	_
to	TO	_
protect	VB	_
normal	JJ	_
tissue	NN	_
near	IN	_
the	DT	_
warts	NNS	_
from	IN	_
irritation	NN	_
.	.	_

A	DT	_
health	NN	_
professional	NN	_
usually	RB	_
applies	VBZ	_
the	DT	_
resin	NN	_
once	RB	_
a	DT	_
week	NN	_
for	IN	_
at	IN	_
least	RBS	_
6	CD	_
weeks	NNS	_
or	CC	_
until	IN	_
warts	NNS	_
disappear	VBP	_
.	.	_

It	PRP	_
is	VBZ	_
unstable	JJ	_
and	CC	_
therefore	RB	_
must	MD	_
be	VB	_
prepared	VBN	_
shortly	RB	_
before	IN	_
use	NN	_
,	,	_
which	WDT	_
has	VBZ	_
possibly	RB	CUE-1
led	VBD	_
to	IN	_
the	DT	_
lower	JJR	_
efficacy	NN	_
shown	VBN	_
in	IN	_
some	DT	CUE-2
clinical	JJ	CUE-2
trials	NNS	CUE-2
.	.	_

