It	PRP	_
uses	VBZ	_
a	DT	_
special	JJ	_
format	NN	_
for	IN	_
storing	VBG	_
them	PRP	_
,	,	_
and	CC	_
people	NNS	_
update	VBP	_
the	DT	_
database	NN	_
using	VBG	_
that	DT	_
type	NN	_
of	IN	_
file	NN	_
.	.	_

Updates	NNS	_
for	IN	_
serial	JJ	_
database	NN	_
software	NN	_
can	MD	_
be	VB	_
found	VBN	_
on	IN	_
many	JJ	CUE-1
Internet	NN	CUE-1
sites	NNS	CUE-1
.	.	_

The	DT	_
most	RBS	_
common	JJ	_
usage	NN	_
of	IN	_
Oscar	NNP	_
is	VBZ	_
for	IN	_
warez	NN	_
software	NN	_
.	.	_

Phrozen	NNP	_
Crew	NNP	_
was	VBD	_
one	CD	_
of	IN	_
the	DT	_
first	JJ	_
warez	NN	_
groups	NNS	_
use	VBP	_
the	DT	_
Oscar	NNP	_
format	NN	_
to	TO	_
release	VB	_
thousands	NNS	_
of	IN	_
license	NN	_
keys	NNS	_
at	IN	_
once	RB	_
.	.	_

