The	DT	_
Five	CD	_
Americans	NNPS	_
are	VBP	_
known	VBN	_
for	IN	_
their	PRP$	_
hit	NN	_
song	NN	_
"	``	_
Western	NNP	_
Union	NNP	_
"	''	_
.	.	_

The	DT	_
Ides	NNP	_
of	IN	_
March	NNP	_
had	VBD	_
a	DT	_
quite	RB	_
different	JJ	_
hit	NN	_
song	NN	_
several	JJ	_
years	NNS	_
after	IN	_
this	DT	_
track	NN	_
was	VBD	_
recorded	VBN	_
called	VBD	_
"	``	_
Vehicle	NN	_
"	''	_
(	-LRB-	_
referred	VBN	_
to	IN	_
on	IN	_
the	DT	_
liner	NN	_
notes	NNS	_
of	IN	_
this	DT	_
album	NN	_
as	IN	_
a	DT	_
"	``	_
horn	NN	_
dirge	NN	_
"	''	_
)	-RRB-	_
.	.	_

The	DT	_
marvelous	JJ	_
cover	NN	_
of	IN	_
"	``	_
The	DT	_
Train	NNP	_
Kept	NNP	_
A	NNP	_
-	HYPH	_
Rollin	NNP	_
"	''	_
by	IN	_
Steve	NNP	_
Walker	NNP	_
&	CC	_
the	DT	_
Bold	NNP	_
is	VBZ	_
played	VBN	_
much	RB	_
faster	RBR	_
than	IN	_
most	JJS	_
other	JJ	_
recordings	NNS	_
of	IN	_
this	DT	_
classic	NN	_
.	.	_

The	DT	_
Ugly	NNP	_
Ducklings	NNS	_
are	VBP	_
one	CD	_
of	IN	_
several	JJ	CUE-1
Canadian	JJ	CUE-1
bands	NNS	CUE-1
whose	WP$	_
songs	NNS	_
are	VBP	_
sprinkled	VBN	_
on	IN	_
the	DT	_
albums	NNS	_
in	IN	_
the	DT	_
Pebbles	NNPS	_
series	NN	_
.	.	_

