Trait	NNP	_
models	NNS	_
have	VBP	CUE-1
been	VBN	CUE-1
criticized	VBN	CUE-1
as	IN	_
being	VBG	_
purely	RB	_
descriptive	JJ	_
and	CC	_
offering	VBG	_
little	JJ	_
explanation	NN	_
of	IN	_
the	DT	_
underlying	VBG	_
causes	NNS	_
of	IN	_
personality	NN	_
.	.	_

Eysenck	NNP	_
's	POS	_
theory	NN	_
,	,	_
however	RB	_
,	,	_
does	VBZ	_
propose	VB	_
biological	JJ	_
mechanisms	NNS	_
as	IN	_
driving	VBG	_
traits	NNS	_
,	,	_
and	CC	_
modern	JJ	_
behavior	NN	_
genetics	NNS	_
researchers	NNS	_
have	VBP	_
shown	VBN	_
a	DT	_
clear	JJ	_
genetic	JJ	_
substrate	NN	_
to	IN	_
them	PRP	_
.	.	_

Another	DT	_
potential	JJ	_
weakness	NN	_
of	IN	_
trait	NN	_
theories	NNS	_
is	VBZ	_
that	IN	_
they	PRP	_
lead	VBP	_
people	NNS	_
to	TO	_
accept	VB	_
oversimplified	JJ	_
classifications	NNS	_
,	,	_
or	CC	_
worse	JJR	_
offer	NN	_
advice	NN	_
,	,	_
based	VBN	_
on	IN	_
a	DT	_
superficial	JJ	_
analysis	NN	_
of	IN	_
their	PRP$	_
personality	NN	_
.	.	_

Finally	RB	_
,	,	_
trait	NN	_
models	NNS	_
often	RB	_
underestimate	VBP	_
the	DT	_
effect	NN	_
of	IN	_
specific	JJ	_
situations	NNS	_
on	IN	_
people	NNS	_
's	POS	_
behavior	NN	_
.	.	_

