King	NNP	_
Street	NNP	_
,	,	_
half	PDT	_
the	DT	_
Market	NNP	_
Square	NNP	_
and	CC	_
some	DT	CUE-1
of	IN	CUE-1
the	DT	CUE-1
Brook	NNP	CUE-1
End	NN	CUE-1
area	NN	CUE-1
were	VBD	_
destroyed	VBN	_
.	.	_

It	PRP	CUE-1
was	VBD	CUE-1
reported	VBN	CUE-1
to	TO	_
have	VB	_
burned	VBN	_
for	IN	_
a	DT	_
day	NN	_
.	.	_

Local	JJ	_
people	NNS	_
raised	VBD	_
L6,000	NNP	_
to	TO	_
help	VB	_
those	DT	_
most	RBS	_
in	IN	_
need	NN	_
.	.	_

Providing	VBG	_
temporary	JJ	_
accommodation	NN	_
in	IN	_
nearby	JJ	_
fields	NNS	_
for	IN	_
the	DT	_
townsfolk	NNS	_
alone	RB	_
cost	VBD	_
L25,000	NNP	_
.	.	_

Rebuilding	VBG	_
after	IN	_
the	DT	_
fire	NN	_
has	VBZ	_
left	VBN	_
the	DT	_
town	NN	_
with	IN	_
a	DT	_
number	NN	_
of	IN	_
Georgian	JJ	_
buildings	NNS	_
.	.	_

