The	DT	_
march	NN	_
to	TO	_
Logansport	NNP	_
had	VBD	_
been	VBN	_
under	IN	_
a	DT	_
hot	JJ	_
sun	NN	_
through	IN	_
the	DT	_
dust	NN	_
cloud	NN	_
kicked	VBD	_
up	RP	_
by	IN	_
the	DT	_
movement	NN	_
of	IN	_
people	NNS	_
and	CC	_
animals	NNS	_
.	.	_

There	EX	_
were	VBD	_
sick	JJ	_
people	NNS	_
and	CC	_
people	NNS	_
dying	VBG	_
in	IN	_
all	DT	_
directions	NNS	_
.	.	_

The	DT	_
heat	NN	_
has	VBZ	_
weakened	VBN	_
most	RBS	_
if	IN	_
not	RB	_
all	DT	_
of	IN	_
the	DT	_
children	NNS	_
.	.	_

I	PRP	_
baptized	VBD	_
several	JJ	_
who	WP	_
were	VBD	_
newly	RB	_
born	VBN	_
-	HYPH	_
happy	JJ	_
Christians	NNPS	_
,	,	_
who	WP	_
with	IN	_
their	PRP$	_
first	JJ	_
step	NN	_
pass	NN	_
from	IN	_
earth	NN	_
to	IN	_
heaven	NNP	_
.	.	_

