The	DT	_
administrations	NNS	_
of	IN	_
Ronald	NNP	_
Reagan	NNP	_
and	CC	_
George	NNP	_
H.W.	NNP	_
Bush	NNP	_
authorized	VBD	_
the	DT	_
sale	NN	_
to	IN	_
Iraq	NNP	_
of	IN	_
numerous	JJ	_
items	NNS	_
that	WDT	_
had	VBD	_
both	DT	_
military	JJ	_
and	CC	_
civilian	JJ	_
applications	NNS	_
,	,	_
including	VBG	_
dual	JJ	_
-	HYPH	_
use	NN	_
chemicals	NNS	_
(	-LRB-	_
e.g.	RB	_
,	,	_
thiodigycol	NN	_
)	-RRB-	_
and	CC	_
bacterial	JJ	_
cultures	NNS	_
,	,	_
such	JJ	_
as	IN	_
'	``	_
Bacillus	NNP	_
anthracis'(anthrax	NNP	_
)	-RRB-	_
and	CC	_
'	``	_
Yersinia	NNP	_
pestis'(plague	NN	_
)	-RRB-	_
.	.	_

Opinions	NNS	CUE-1
differ	VBP	_
among	IN	_
Middle	NNP	CUE-2
East	NNP	CUE-2
experts	NNS	CUE-2
and	CC	_
former	JJ	_
government	NN	CUE-3
officials	NNS	CUE-3
about	IN	_
the	DT	_
pre	NN	_
-	HYPH	_
Iraqi	JJ	_
tilt	NN	_
,	,	_
and	CC	_
whether	IN	_
Washington	NNP	_
could	MD	_
have	VB	_
done	VBN	_
more	RBR	_
to	TO	_
stop	VB	_
the	DT	_
flow	NN	_
to	IN	_
Baghdad	NNP	_
of	IN	_
technology	NN	_
for	IN	_
building	VBG	_
weapons	NNS	_
of	IN	_
mass	JJ	_
destruction	NN	_
.	.	_

"	``	_
Fundamentally	RB	_
,	,	_
the	DT	_
policy	NN	_
was	VBD	_
justified	VBN	_
,	,	_
"	''	_
argues	VBZ	_
David	NNP	_
Newton	NNP	_
,	,	_
a	DT	_
former	JJ	_
U.S.	NNP	_
ambassador	NN	_
to	IN	_
Baghdad	NNP	_
,	,	_
who	WP	_
runs	VBZ	_
an	DT	_
anti	JJ	_
-	HYPH	_
Hussein	NNP	_
radio	NN	_
station	NN	_
in	IN	_
Prague	NNP	_
.	.	_

"	``	_
We	PRP	_
were	VBD	_
concerned	VBN	_
that	IN	_
Iraq	NNP	_
should	MD	_
not	RB	_
lose	VB	_
the	DT	_
war	NN	_
with	IN	_
Iran	NNP	_
,	,	_
because	IN	_
that	DT	_
would	MD	_
have	VB	_
threatened	VBN	_
Saudi	NNP	_
Arabia	NNP	_
and	CC	_
the	DT	_
Gulf	NNP	_
.	.	_

Our	PRP$	_
long	JJ	_
-	HYPH	_
term	NN	_
hope	NN	_
was	VBD	_
that	IN	_
Hussein	NNP	_
's	POS	_
government	NN	_
would	MD	_
become	VB	_
less	RBR	_
repressive	JJ	_
and	CC	_
more	JJR	_
responsible	JJ	_
.	.	_
"	''	_

