The	DT	_
filmmakers	NNS	_
hired	VBD	_
deaf	JJ	_
lip	NN	_
readers	NNS	_
to	TO	_
help	VB	_
compose	VB	_
dialogue	NN	_
to	TO	_
match	VB	_
the	DT	_
lip	NN	_
movements	NNS	_
of	IN	_
the	DT	_
original	JJ	_
Japanese	JJ	_
actors	NNS	_
,	,	_
and	CC	_
filled	VBN	_
in	IN	_
the	DT	_
narrative	NN	_
gaps	NNS	_
by	IN	_
adding	VBG	_
voice	NN	_
-	HYPH	_
over	IN	_
narration	NN	_
by	IN	_
Daigoro	NNP	_
,	,	_
performed	VBN	_
by	IN	_
the	DT	_
7-year	NNP	_
-	HYPH	_
old	JJ	_
son	NN	_
of	IN	_
'	``	_
Shogun	NNP	_
Assassin	NNP	_
's	POS	_
'	''	_
poster	NN	_
illustrator	NN	_
.	.	_

American	JJ	_
actor	NN	_
Sandra	NNP	_
Bernhard	NNP	_
and	CC	_
director	NN	_
(	-LRB-	_
and	CC	_
former	JJ	_
radio	NN	_
actor	NN	_
)	-RRB-	_
Lamont	NNP	_
Johnson	NNP	_
provided	VBD	_
voices	NNS	_
in	IN	_
the	DT	_
dubbed	VBN	_
edition	NN	_
.	.	_

