Then	RB	_
,	,	_
all	PDT	_
the	DT	_
efforts	NNS	_
of	IN	_
French	JJ	_
officials	NNS	_
to	TO	_
convince	VB	_
their	PRP$	_
king	NN	_
to	TO	_
pay	VB	_
for	IN	_
another	DT	_
Apostle	NNP	_
statue	NN	_
in	IN	_
the	DT	_
Lateran	NNP	_
and	CC	_
employ	VB	_
Le	NNP	_
Gros	NNP	_
to	TO	_
make	VB	_
it	PRP	_
,	,	_
led	VBD	_
to	IN	_
nothing	NN	_
.	.	_

He	PRP	_
would	MD	_
finally	RB	_
have	VB	_
to	TO	_
recognise	VB	_
that	IN	_
he	PRP	_
was	VBD	_
fighting	VBG	_
a	DT	_
losing	VBG	_
battle	NN	_
against	IN	_
Rusconi	NNP	_
,	,	_
who	WP	_
was	VBD	_
by	IN	_
then	RB	_
clearly	RB	_
favoured	VBN	_
by	IN	_
Pope	NNP	_
Clement	NNP	_
XI.	NNP	_

Here	RB	_
the	DT	_
last	JJ	_
sad	JJ	_
chapter	NN	_
of	IN	_
his	PRP$	_
life	NN	_
opened	VBD	_
promptly	RB	_
when	WRB	_
he	PRP	_
sided	VBD	_
with	IN	_
some	DT	CUE-1
dissidents	NNS	CUE-1
who	WP	_
opposed	VBD	_
the	DT	_
introduction	NN	_
of	IN	_
new	JJ	_
rules	NNS	_
at	IN	_
the	DT	_
Accademia	NNP	_
di	FW	_
San	NNP	_
Luca	NNP	_
which	WDT	_
subjected	VBD	_
non	AFX	_
-	HYPH	_
members	NNS	_
to	TO	_
great	JJ	_
financial	JJ	_
unjustice	NN	_
,	,	_
and	CC	_
he	PRP	_
was	VBD	_
unceremoniously	RB	_
expelled	VBN	_
.	.	_

The	DT	_
rich	JJ	_
Roman	JJ	_
art	NN	_
market	NN	_
was	VBD	_
effectively	RB	_
closed	VBN	_
for	IN	_
him	PRP	_
and	CC	_
he	PRP	_
had	VBD	_
to	TO	_
settle	VB	_
for	IN	_
a	DT	_
few	JJ	_
works	NNS	_
outside	RB	_
,	,	_
namely	RB	_
some	DT	_
statues	NNS	_
for	IN	_
the	DT	_
Benedictine	NNP	_
abbey	NN	_
at	IN	_
Monte	NNP	_
Cassino	NNP	_
(	-LRB-	_
after	IN	_
the	DT	_
heavy	JJ	_
bombing	NN	_
in	IN	_
World	NNP	_
War	NNP	_
II	NNP	_
,	,	_
only	RB	_
his	PRP$	_
'	``	_
Emperor	NNP	_
Henry	NNP	_
II	NNP	_
'	''	_
shows	VBZ	_
a	DT	_
reasonable	JJ	CUE-1
degree	NN	CUE-1
of	IN	CUE-1
authenticity	NN	CUE-1
after	IN	_
restoration	NN	_
)	-RRB-	_
and	CC	_
,	,	_
without	IN	CUE-2
doubt	NN	CUE-2
due	IN	_
to	IN	_
the	DT	_
intervention	NN	_
of	IN	_
Juvarra	NNP	_
who	WP	_
was	VBD	_
by	IN	_
then	RB	_
architect	NN	_
to	IN	_
the	DT	_
Duke	NNP	_
of	IN	_
Savoy	NNP	_
,	,	_
two	CD	_
female	JJ	_
saints	NNS	_
for	IN	_
the	DT	_
church	NN	_
of	IN	_
S.	NNP	_
Cristina	NNP	_
in	IN	_
Turin	NNP	_
(	-LRB-	_
now	RB	_
in	IN	_
the	DT	_
Cathedral	NNP	_
)	-RRB-	_
.	.	_

