The	DT	_
coin	NN	_
almost	RB	_
made	VBD	_
a	DT	_
return	NN	_
in	IN	_
1964	CD	_
,	,	_
when	WRB	_
Congress	NNP	_
approved	VBD	_
the	DT	_
mintage	NN	_
of	IN	_
45	CD	_
million	CD	_
new	JJ	_
silver	NN	_
dollars	NNS	_
to	TO	_
fulfill	VB	_
the	DT	_
needs	NNS	_
of	IN	_
the	DT	_
booming	JJ	_
casino	NN	_
industry	NN	_
in	IN	_
Nevada	NNP	_
..	.	_

Retrieved	VBN	_
June	NNP	_
25	CD	_
,	,	_
2006	CD	_
.	.	_
The	DT	_
decision	NN	_
was	VBD	_
controversial	JJ	_
due	IN	_
to	IN	_
a	DT	_
critical	JJ	_
silver	NN	_
shortage	NN	_
in	IN	_
1965	CD	_
,	,	_
which	WDT	_
led	VBD	_
to	IN	_
widespread	JJ	_
hoarding	NN	_
of	IN	_
silver	JJ	_
coinage	NN	_
..	.	_

But	CC	_
under	IN	_
pressure	NN	_
from	IN	_
some	DT	CUE-1
members	NNS	CUE-1
of	IN	_
Congress	NNP	_
from	IN	_
the	DT	_
Western	JJ	_
states	NNS	_
,	,	_
President	NNP	_
Lyndon	NNP	_
B.	NNP	_
Johnson	NNP	_
issued	VBD	_
an	DT	_
order	NN	_
on	IN	_
May	NNP	_
15	CD	_
,	,	_
1965	CD	_
to	TO	_
resume	VB	_
production	NN	_
of	IN	_
the	DT	_
Peace	NNP	_
Dollar	NNP	_
.	.	_

Although	IN	_
rumors	NNS	CUE-1
persist	VB	_
that	IN	_
some	DT	CUE-2
examples	NNS	CUE-2
still	RB	_
survive	VBP	_
,	,	_
owning	VBG	_
them	PRP	_
is	VBZ	_
illegal	JJ	_
,	,	_
making	VBG	_
it	PRP	_
unlikely	JJ	_
that	IN	_
anyone	NN	_
who	WP	_
does	VBZ	_
own	VB	_
one	NN	_
will	MD	_
ever	RB	_
come	VB	_
forth	RB	_
publicly	RB	_
.	.	_

